level.1                                                       
111111111111111111111111111111111111111111111111111500000111111101120111111101100111111100000111111101101111111101101111111100000041111111111111
111111111111111111111111111111111111111111111111111500000111111101120111111101100111111100000111111101101111111101101111111100000041111111111111
level.2
111111111111111111111111111111111111111111111111111500000111111101120111111101100111111100000111111101101111111101101111111100000041111111111111
111111111111111111111111111111111111111111111111111500000111111101120111111101100111111100000111111101101111111101101111111100000041111111111111
level.3
111111111111111111111111111111111111111111111111111000000111111101100111111101100111111107000111111101121111111101101111111100000041111111111111
111111111111111111111111111111111111111111111111111000000111111101100111111101100111111160000111111101101111111101101111111100020041111111111111
level.4
111111111111111111111111111111111111111111111111111500000111111101120111111101100111111100000111111101101111111101101111111100000041111111111111
111111111111111111111111111111111111111111111111111500000111111101120111111101100111111100000111111101101111111101101111111100000041111111111111
level.5
111111111111111111111111111111111111111111111111111500000111111101120111111101100111111100000111111101101111111101101111111100000041111111111111
111111111111111111111111111111111111111111111111111500000111111101120111111101100111111100000111111101101111111101101111111100000041111111111111
